Data,Descrição,Valor,Saldo
01/08/2025,Supermercado,-25.0,1457.0
02/08/2025,Uber,-18.0,1439.0
03/08/2025,Salário,1500.0,2939.0
04/08/2025,Cinema,-200.0,2739.0
05/08/2025,Padaria,-30.0,2709.0
05/08/2025,Transferência recebida,200.0,2909.0
